#......................................................#
#......................................................#
#......................................................#
#...........""......."""...."""...........##############
#...#####......................."......................#
#................................."""........######....#
#.......#####..........####............................#
#..............""""...######...........................#
#....................########......."""""".............#
#####...............##########.........................#
#......""""........############..........""""""".......#
#............""...##############.......................#
#................################......................#
#...............##################.....................#
""""""""""""""""""""""""""""""""""""""""""""""""""""""""
