#......................................................#
#......................................................#
#......................................................#
#..........."".......""""""""""...........##############
#......................................................#
#......................................................#
#.......##.............###.............................#
#..............""""............""......................#
#......................................................#
#......................................................#
#..........."......."""""""...........""""""...........#
#......................................................#
#........""""""............."""..."....................#
#......................................................#
""""""""""""""""""""""""""""""""""""""""""""""""""""""""
