#......................................................#
#......................................................#
#......................................................#
#..........."".......""""""""""...........##############
#...#####..............................................#
#............................................######....#
#.......##.............###.............................#
#..............""""....................................#
#..............................""""""".................#
#.###......................"...........................#
#......""""..........."""""""..........."""""""........#
#................"""...................................#
#........""""""............."""..."....................#
#......................................................#
""""""""""""""""""""""""""""""""""""""""""""""""""""""""
